1111111111111
1001000100001
1001010000001
1000011111001
1P0011E000001
1111111111111