1111111111111
100100010C001
10010100000C1
100C011111001
1P0011E000001
0111111111110