111111111111111
10M1000C01CM001
10010100M00C001
100C01111100111
1P0011E0CM00001
101001111100101
1C100M0C00001C1
111111111111111