1111111111111
10M100010CM01
10010100M00C1
100C011111001
1P0011E000001
1111111111111